R 600 600
NO textures/gamm.xpm
SO textures/gonn.xpm
WE textures/gunn.xpm
EA textures/leee.xpm

S textures/S_blackhole3.xpm
C 30,0,0
F 0,0,0

1   1   1111111111111111111111111
1   1   1000000000110000000000001
1   1   1011000001110111002000001
1       10010000002001 1000200001
111111111011020001110111002000001
100022000011002001110111111111111
11110111111111011100000010001   
11110111111111011101010010001
11200020110101011100000010201
10002N00200000001100000010201
10000200000002001101010010201
11220001110101011111011110101
11110111 1110101 101111010001
11111111 1111111 111111111111
