R 600 600
NO textures/aja_rabbit.xpm
SO textures/daebak_rabbit.xpm
WE textures/dingul_rabbit.xpm
EA textures/think_rabbit.xpm

S textures/dance_rabbit.xpm
B textures/hi_rabbit.xpm

F textures/flower.xpm
C 100,200,100

        1111111111111111111111111
        1000000000110000000000001
        1011000001110000002000001
        1001000000200000000200001
111111111011020001110000002000001
100022000011002001110111111111111
11110111111111011100000010001
11110111111111011101010010001
11200020110101311100000010201
10002N00204004001100000010201
10000200000002001101010010201
1122000111010101111101111010111
11110111 1110101 101111010001
11111111 1111111 111111111111
